R..........................R
R..........................R
R..........................R
R..........................R
R..........................R
R..........................R
R..RRRR..............RRRR..R
R..........................R
R..........................R
R..........................R
R..........................R
R..........RRRRRR..........R
R..........................R
R..........................R
R..........................R
RBGGGGGGGGGIIIIIIGGGGGGGGGBR